NO textures/cubBB.xpm
SO textures/cubBG.xpm
WE textures/cubBP.xpm
EA textures/cubBY.xpm

F 050, 050, 050
C 125, 125, 125

11111111111111111
10000000000000001
10000000000000001
10000000000000001
10000000000000001
10000000000000001
10000000E00000001
10000000000000001
10000000000000001
10000000000000001
10000000000000001
10000000000000001
11111111111111111


