NO textures/cubBB.xpm
SO textures/cubBG.xpm
WE textures/cubBP.xpm
EA textures/cubBY.xpm

F 100, 100, 100
C 125, 125, 125

111111111111111
111111101111111
111111000111111
111110000011111
1111000N0001111
111000010000111
110000111000011
100001111100001
110000111000011
111000010000111
111100000001111
111110000011111
111111101111111
111111000111111
111111101111111
111111111111111

