NO textures/cubBB.xpm
SO textures/cubBG.xpm
WE textures/cubBP.xpm
EA textures/cubBY.xpm

F 050, 050, 050
C 125, 125, 125

1111111
1000001
100S001
10000011111111111111111111111111111
10000000000000010000000000000000001
11111111001001001001001111111001001
    1000001000001001001000001001001
    1001111111111111111111001001001
    1000000001000000000000001001001
    1111111001001111111001111001111
    1000000000001000001001001001001
    1111001111001001111111001001001
    1000001001000001000000000000001
    1111001001001111111111111111001
    1000001000000000001000000000001
    1001111001001111001111111111111
    1000001001001001000000000000001
    1111111001001001111001111001111
    1001001001001000000000001000001
    1001001001111111111001001111001
    1001001000001001001001001000001
    1001001111111001001111111001001111
    1000000000000000000000000001000001
    1111111111111111111111111111000001
                               1000001
                               1000001
                               1111111