NO textures/cubBB.xpm
SO textures/cubBG.xpm
WE textures/cubBP.xpm
EA textures/cu

F 100, 100, 100
C 125, 125, 125

11111111111111111
10000000000000001
10000000000000001
10000000000000001
10000000000000001
10000000000000001
1000000000000001
10000000000000001
10000000000000001
10000000000000001
10000000000000001
10000000000000001
11111111111111111


